5 4 12 10 7 6 11 10 3 3 9 9 7 2 4 12 5 7 2 8 5 12 1 6 2 5 4 3 10 12 7 11 8 11 1 8 8 1 6 11 4 1 2 9 6 9 10 3
5 7 8 1 3 6 10 11 12 11 8 10 5 3 12 8 6 7 2 9 1 6 4 10 11 4 2 10 4 9 7 7 4 5 12 1 9 3 5 2 2 1 11 6 8 9 3 12
8 12 9 1 2 7 10 3 12 1 7 4 5 8 4 7 4 6 12 1 5 6 9 6 3 1 12 3 10 2 10 8 3 6 5 9 2 5 10 7 11 11 11 2 11 4 9 8
7 3 7 9 12 6 10 4 4 11 3 3 8 12 1 1 4 6 5 4 9 5 9 12 2 6 10 2 3 11 8 1 7 9 10 12 2 11 7 11 6 8 5 1 10 2 5 8
10 8 5 8 3 8 6 9 10 7 7 10 1 5 9 6 3 1 9 12 12 2 4 12 1 8 2 11 3 4 1 6 10 12 3 11 4 5 4 9 11 6 11 7 2 2 7 5
11 7 4 10 10 12 1 7 11 5 6 11 8 4 8 12 9 10 12 9 2 5 3 6 1 6 2 3 12 9 8 7 3 7 4 5 4 11 10 2 1 1 8 3 6 2 9 5
2 4 1 12 10 8 9 3 3 7 1 8 6 10 11 8 7 1 2 3 9 5 11 10 6 7 9 4 4 9 5 3 5 10 11 7 12 2 2 1 8 12 12 5 11 6 4 6